        1   0 ^@   212 M-^J
        2   0 ^@   204 M-^D
        3   0 ^@   344 M-d
        4   0 ^@     3 ^C
        7   0 ^@    10 ^H
       12   0 ^@     2 ^B
       13   0 ^@    40  
       15   0 ^@     3 ^C
       18   0 ^@   344 M-d
       21   0 ^@   106 F
       22   0 ^@   103 C
       23   0 ^@    60 0
       24   0 ^@    60 0
       25   0 ^@    60 0
       26   0 ^@    60 0
       27   0 ^@    60 0
       28   0 ^@    60 0
       29   0 ^@    60 0
       30   0 ^@    60 0
       31   0 ^@    40  
       32   0 ^@    40  
       33   0 ^@    40  
       34   0 ^@    40  
       35   0 ^@    40  
       36   0 ^@    40  
       37   0 ^@    40  
       38   0 ^@    40  
       39   0 ^@    40  
       40   0 ^@    40  
       41   0 ^@     1 ^A
       43   0 ^@     1 ^A
       45   0 ^@     4 ^D
       47   0 ^@    60 0
       48   0 ^@   116 N
       49   0 ^@    61 1
       50   0 ^@    65 5
       51   0 ^@    61 1
       52   0 ^@    61 1
       53   0 ^@   104 D
       54   0 ^@    65 5
       55   0 ^@   154 l
       56   0 ^@   106 F
       57   0 ^@   163 s
       58   0 ^@   141 a
       59   0 ^@    40  
       60   0 ^@   150 h
       61   0 ^@   141 a
       62   0 ^@   103 C
       63   0 ^@   144 d
       64   0 ^@   162 r
       65   0 ^@    40  
       66   0 ^@    40  
       67   0 ^@    40  
       68   0 ^@    40  
       69   0 ^@    40  
       70   0 ^@    40  
       71   0 ^@    40  
       72   0 ^@    40  
       73   0 ^@    40  
       74   0 ^@    40  
       75   0 ^@    40  
       76   0 ^@    40  
       77   0 ^@    40  
       78   0 ^@    40  
       79   0 ^@    40  
       80   0 ^@    40  
       81   0 ^@    40  
       82   0 ^@    40  
       83   0 ^@    40  
       84   0 ^@    40  
       85   0 ^@    40  
       86   0 ^@    40  
       87   0 ^@    40  
       88   0 ^@    40  
       89   0 ^@    40  
       90   0 ^@    40  
       91   0 ^@    40  
       92   0 ^@    40  
       93   0 ^@    40  
       94   0 ^@    40  
       95   0 ^@     1 ^A
      100   0 ^@    17 ^O
      104   0 ^@     2 ^B
      107   0 ^@     3 ^C
      109   0 ^@   344 M-d
      110   0 ^@     3 ^C
      111   0 ^@    10 ^H
      113   0 ^@    40  
      116   0 ^@   344 M-d
      117   0 ^@     3 ^C
      120   0 ^@     1 ^A
      122   0 ^@   344 M-d
      123   0 ^@     3 ^C
      127   0 ^@     7 ^G
      128   0 ^@     4 ^D
      129   0 ^@     3 ^C
      131   0 ^@   170 x
      133   0 ^@   170 x
      135   0 ^@   170 x
      137   0 ^@   170 x
      258   0 ^@     3 ^C
      259   0 ^@   344 M-d
      261   0 ^@    61 1
      262   0 ^@    61 1
      263   0 ^@    65 5
      264   0 ^@    61 1
      265   0 ^@    70 8
      266   0 ^@   142 b
